# reference: http://www.thealmightyguru.com/Wiki/index.php?title=File:Dragon_Warrior_-_NES_-_Map_-_Garin%27s_Grave.png

map_name Garinham
map_tileset tileset
map_music town
map_out_of_bounds_tile_id 36
map_is_dark false
map_repel_has_no_effect true
map_reset_repel_on_enter true
map_reset_light_on_enter true
# col1 row1 col2 row2 teleportMapId teleportCol teleportRow teleportPlayerDirection areaUseFadeEffect, areaMusicId, areaIsDark, areaRepelHasNoEffect, areaResetRepel, areaResetLight
map_area 9 9 28 29 world 6 6 down true world false false false true
map_rows 40
map_cols 211
map_data
0,0,0,0,0,0,0,0,0,0,0,0,0,0,0,0,0,0,0,0,0,0,0,0,0,0,0,0,0,0,0,0,0,0,0,0,0,0,36,36,36,36,36,36,36,36,36,36,36,36,36,36,36,36,36,36,36,36,36,36,36,36,36,36,36,36,36,36,36,36,36,36,36,36,36,36,36,36,36,36,36,36,36,36,36,36,36,36,36,36,36,36,36,36,36,36,36,36,36,36,36,36,36,36,36,36,36,36,36,36,36,36,36,36,36,36,36,36,36,36,36,36,36,36,36,36,36,36,36,36,36,36,36,36,36,36,36,36,36,36,36,36,36,36,36,36,36,36,36,36,36,36,36,36,36,36,36,36,36,36,36,36,36,36,36,36,36,36,36,36,36,36,36,36,36,36,36,36,36,36,36,36,36,36,36,36,36,36,36,36,36,36,36,36,36,36,36,36,36,36,36,36,36,36,36,36,36,36,36,36,36
0,0,0,0,0,0,0,0,0,0,0,0,0,0,0,0,0,0,0,0,0,0,0,0,0,0,0,0,0,0,0,0,0,0,0,0,0,0,36,36,36,36,36,36,36,36,36,36,36,36,36,36,36,36,36,36,36,36,36,36,36,36,36,36,36,36,36,36,36,36,36,36,36,36,36,36,36,36,36,36,36,36,36,36,36,36,36,36,36,36,36,36,36,36,36,36,36,36,36,36,36,36,36,36,36,36,36,36,36,36,36,36,36,36,36,36,36,36,36,36,36,36,36,36,36,36,36,36,36,36,36,36,36,36,36,36,36,36,36,36,36,36,36,36,36,36,36,36,36,36,36,36,36,36,36,36,36,36,36,36,36,36,36,36,36,36,36,36,36,36,36,36,36,36,36,36,36,36,36,36,36,36,36,36,36,36,36,36,36,36,36,36,36,36,36,36,36,36,36,36,36,36,36,36,36,36,36,36,36,36,36
0,0,0,0,0,0,0,0,0,0,0,0,0,0,0,0,0,0,0,0,0,0,0,0,0,0,0,0,0,0,0,0,0,0,0,0,0,0,36,36,36,36,36,36,36,36,36,36,36,36,36,36,36,36,36,36,36,36,36,36,36,36,36,36,36,36,36,36,36,36,36,36,36,36,36,36,36,36,36,36,36,36,36,36,36,36,36,36,36,36,36,36,36,36,36,36,36,36,36,36,36,36,36,36,36,36,36,36,36,36,36,36,36,36,36,36,36,36,36,36,36,36,36,36,36,36,36,36,36,36,36,36,36,36,36,36,36,36,36,36,36,36,36,36,36,36,36,36,36,36,36,36,36,36,36,36,36,36,36,36,36,36,36,36,36,36,36,36,36,36,36,36,36,36,36,36,36,36,36,36,36,36,36,36,36,36,36,36,36,36,36,36,36,36,36,36,36,36,36,36,36,36,36,36,36,36,36,36,36,36,36
0,0,0,0,0,0,0,0,0,0,0,0,0,0,0,0,0,0,0,0,0,0,0,0,0,0,0,0,0,0,0,0,0,0,0,0,0,0,36,36,36,36,36,36,36,36,36,36,36,36,36,36,36,36,36,36,36,36,36,36,36,36,36,36,36,36,36,36,36,36,36,36,36,36,36,36,36,36,36,36,36,36,36,36,36,36,36,36,36,36,36,36,36,36,36,36,36,36,36,36,36,36,36,36,36,36,36,36,36,36,36,36,36,36,36,36,36,36,36,36,36,36,36,36,36,36,36,36,36,36,36,36,36,36,36,36,36,36,36,36,36,36,36,36,36,36,36,36,36,36,36,36,36,36,36,36,36,36,36,36,36,36,36,36,36,36,36,36,36,36,36,36,36,36,36,36,36,36,36,36,36,36,36,36,36,36,36,36,36,36,36,36,36,36,36,36,36,36,36,36,36,36,36,36,36,36,36,36,36,36,36
0,0,0,0,0,0,0,0,0,0,0,0,0,0,0,0,0,0,0,0,0,0,0,0,0,0,0,0,0,0,0,0,0,0,0,0,0,0,36,36,36,36,36,36,36,36,36,36,36,36,36,36,36,36,36,36,36,36,36,36,36,36,36,36,36,36,36,36,36,36,36,36,36,36,36,36,36,36,36,36,36,36,36,36,36,36,36,36,36,36,36,36,36,36,36,36,36,36,36,36,36,36,36,36,36,36,36,36,36,36,36,36,36,36,36,36,36,36,36,36,36,36,36,36,36,36,36,36,36,36,36,36,36,36,36,36,36,36,36,36,36,36,36,36,36,36,36,36,36,36,36,36,36,36,36,36,36,36,36,36,36,36,36,36,36,36,36,36,36,36,36,36,36,36,36,36,36,36,36,36,36,36,36,36,36,36,36,36,36,36,36,36,36,36,36,36,36,36,36,36,36,36,36,36,36,36,36,36,36,36,36
0,0,0,0,0,0,0,0,0,0,0,0,0,0,0,0,0,0,0,0,0,0,0,0,0,0,0,0,0,0,0,0,0,0,0,0,0,0,36,36,36,36,36,36,36,36,36,36,36,36,36,36,36,36,36,36,36,36,36,36,36,36,36,36,36,36,36,36,36,36,36,36,36,36,36,36,36,36,36,36,36,36,36,36,36,36,36,36,36,36,36,36,36,36,36,36,36,36,36,36,36,36,36,36,36,36,36,36,36,36,36,36,36,36,36,36,36,36,36,36,36,36,36,36,36,36,36,36,36,36,36,36,36,36,36,36,36,36,36,36,36,36,36,36,36,36,36,36,36,36,36,36,36,36,36,36,36,36,36,36,36,36,36,36,36,36,36,36,36,36,36,36,36,36,36,36,36,36,36,36,36,36,36,36,36,36,36,36,36,36,36,36,36,36,36,36,36,36,36,36,36,36,36,36,36,36,36,36,36,36,36
0,0,0,0,0,0,0,0,0,0,0,0,0,0,0,0,0,0,0,0,0,0,0,0,0,0,0,0,0,0,0,0,0,0,0,0,0,0,36,36,36,36,36,36,36,36,36,36,36,36,36,36,36,36,36,36,36,36,36,36,36,36,36,36,36,36,36,36,36,36,36,36,36,36,36,36,36,36,36,36,36,36,36,36,36,36,36,36,36,36,36,36,36,36,36,36,36,36,36,36,36,36,36,36,36,36,36,36,36,36,36,36,36,36,36,36,36,36,36,36,36,36,36,36,36,36,36,36,36,36,36,36,36,36,36,36,36,36,36,36,36,36,36,36,36,36,36,36,36,36,36,36,36,36,36,36,36,36,36,36,36,36,36,36,36,36,36,36,36,36,36,36,36,36,36,36,36,36,36,36,36,36,36,36,36,36,36,36,36,36,36,36,36,36,36,36,36,36,36,36,36,36,36,36,36,36,36,36,36,36,36
0,0,0,0,0,0,0,0,0,0,0,0,0,0,0,0,0,0,0,0,0,0,0,0,0,0,0,0,0,0,0,0,0,0,0,0,0,0,36,36,36,36,36,36,36,36,36,36,36,36,36,36,36,36,36,36,36,36,36,36,36,36,36,36,36,36,36,36,36,36,36,36,36,36,36,36,36,36,36,36,36,36,36,36,36,36,36,36,36,36,36,36,36,36,36,36,36,36,36,36,36,36,36,36,36,36,36,36,36,36,36,36,36,36,36,36,36,36,36,36,36,36,36,36,36,36,36,36,36,36,36,36,36,36,36,36,36,36,36,36,36,36,36,36,36,36,36,36,36,36,36,36,36,36,36,36,36,36,36,36,36,36,36,36,36,36,36,36,36,36,36,36,36,36,36,36,36,36,36,36,36,36,36,36,36,36,36,36,36,36,36,36,36,36,36,36,36,36,36,36,36,36,36,36,36,36,36,36,36,36,36
0,0,0,0,0,0,0,0,0,0,0,0,0,0,0,0,0,0,0,0,0,0,0,0,0,0,0,0,0,0,0,0,0,0,0,0,0,0,36,36,36,36,36,36,36,36,36,36,36,36,36,36,36,36,36,36,36,36,36,36,36,36,36,36,36,36,36,36,36,36,36,36,36,36,36,36,36,36,36,36,36,36,36,36,36,36,36,36,36,36,36,36,36,36,36,36,36,36,36,36,36,36,36,36,36,36,36,36,36,36,36,36,36,36,36,36,36,36,36,36,36,36,36,36,36,36,36,36,36,36,36,36,36,36,36,36,36,36,36,36,36,36,36,36,36,36,36,36,36,36,36,36,36,36,36,36,36,36,36,36,36,36,36,36,36,36,36,36,36,36,36,36,36,36,36,36,36,36,36,36,36,36,36,36,36,36,36,36,36,36,36,36,36,36,36,36,36,36,36,36,36,36,36,36,36,36,36,36,36,36,36
0,0,0,0,0,0,0,0,0,19,19,30,32,32,32,32,32,32,32,32,32,32,32,32,32,19,19,30,32,0,0,0,0,0,0,0,0,0,36,36,36,36,36,36,36,36,36,36,36,36,32,36,36,36,36,36,36,36,36,36,36,36,36,36,36,36,36,36,36,36,36,36,36,36,36,36,36,36,36,36,36,36,36,30,30,30,30,30,30,30,30,30,30,30,30,30,30,30,30,30,30,30,30,30,30,36,36,36,36,36,36,36,36,36,36,36,36,36,36,36,36,30,30,30,30,30,30,30,30,30,30,30,30,30,30,30,30,36,36,36,36,36,36,36,36,36,36,36,36,36,36,36,36,36,36,36,36,36,30,30,30,36,36,36,36,36,36,36,36,36,36,36,36,36,36,36,36,36,36,36,36,30,30,30,30,30,30,30,30,30,30,30,30,30,30,30,30,30,30,30,30,30,30,36,36,36,36,36,36,36,36
0,0,0,0,0,0,0,0,0,19,19,30,32,4,4,4,4,4,4,4,4,4,4,4,32,32,9,32,32,0,0,0,0,0,0,0,0,0,36,36,36,36,36,36,36,36,36,30,32,32,32,32,32,32,32,32,32,32,32,32,30,30,30,30,19,19,19,36,36,36,36,36,36,36,36,36,36,36,36,36,36,36,36,30,32,32,32,32,32,32,32,32,30,32,30,32,32,32,30,32,32,32,32,30,30,36,36,36,36,36,36,36,36,36,36,36,36,36,36,36,36,30,32,32,32,32,32,32,32,32,32,32,32,32,32,32,30,36,36,36,36,36,36,36,36,36,36,36,36,36,36,36,36,36,36,36,36,30,30,32,30,30,36,36,36,36,36,36,36,36,36,36,36,36,36,36,36,36,36,36,36,30,32,32,32,30,32,32,32,30,32,32,32,32,32,32,32,32,30,32,32,32,30,36,36,36,36,36,36,36,36
0,0,0,0,0,0,0,0,0,30,30,30,32,30,30,30,30,30,30,30,30,30,30,30,30,30,19,30,30,0,0,0,0,0,0,0,0,0,36,36,36,36,36,36,36,36,36,30,32,30,30,30,30,30,32,32,32,32,32,32,19,19,19,30,19,30,30,36,36,36,36,36,36,36,36,36,36,36,36,36,36,36,36,30,32,30,30,30,30,30,30,32,32,32,30,32,32,32,32,32,30,30,32,32,30,36,36,36,36,36,36,36,36,36,36,36,36,36,36,36,36,30,32,32,30,32,30,30,30,30,30,30,30,32,32,32,30,36,36,36,36,36,36,36,36,36,36,36,36,36,36,36,36,36,36,36,30,30,32,32,32,30,30,36,36,36,36,36,36,36,36,36,36,36,36,36,36,36,36,36,36,30,32,32,32,30,32,32,32,32,32,30,32,30,32,30,32,32,30,32,32,32,30,36,36,36,36,36,36,36,36
0,0,0,0,0,0,0,0,0,31,31,31,32,31,31,31,31,31,31,31,31,31,31,31,31,31,31,31,31,0,0,0,0,0,0,0,0,0,36,36,36,36,36,36,36,36,36,30,32,30,32,32,32,30,32,32,32,32,32,32,30,19,19,19,19,19,30,36,36,36,36,36,36,36,36,36,36,36,36,36,36,36,36,30,32,30,32,32,32,32,30,32,30,32,30,32,32,32,30,32,32,32,30,32,30,36,36,36,36,36,36,36,36,36,36,36,36,36,36,36,36,30,32,30,30,32,32,32,32,32,32,32,30,32,32,32,30,36,36,36,36,36,36,36,36,36,36,36,36,36,36,36,36,36,36,30,30,32,32,30,32,32,30,30,36,36,36,36,36,36,36,36,36,36,36,36,36,36,36,36,36,30,32,32,32,30,32,30,30,30,30,30,32,32,32,32,32,32,30,32,32,32,30,36,36,36,36,36,36,36,36
0,0,0,0,0,0,0,0,0,31,31,31,31,31,31,31,31,31,31,31,31,31,31,31,31,31,31,31,31,0,0,0,0,0,0,0,0,0,36,36,36,36,36,36,36,36,36,30,32,30,30,32,30,30,32,32,32,32,32,32,30,19,30,19,30,19,30,36,36,36,36,36,36,36,36,36,36,36,36,36,36,36,36,30,32,30,32,30,30,32,32,32,30,32,30,32,30,30,30,30,30,32,30,32,30,36,36,36,36,36,36,36,36,36,36,36,36,36,36,36,36,30,32,32,30,30,30,30,30,30,30,32,30,30,30,32,30,36,36,36,36,36,36,36,36,36,36,36,36,36,36,36,36,30,30,30,32,32,30,30,30,32,32,30,30,36,36,36,36,36,36,36,36,36,36,36,36,36,36,36,36,30,32,30,30,30,32,30,32,30,32,30,30,30,30,30,30,30,30,30,30,30,30,36,36,36,36,36,36,36,36
0,0,0,0,0,0,0,0,0,31,31,31,31,31,31,31,31,31,31,31,31,31,31,31,31,31,31,31,31,0,0,0,0,0,0,0,0,0,36,36,36,36,36,36,36,36,36,30,32,32,32,32,32,32,32,32,32,32,32,32,32,32,32,32,32,32,30,36,36,36,36,36,36,36,36,36,36,36,36,36,36,36,36,30,32,30,32,32,32,32,30,30,30,32,30,30,30,32,30,32,30,32,32,32,30,36,36,36,36,36,36,36,36,36,36,36,36,36,36,36,36,30,32,32,30,32,32,32,32,32,32,32,32,32,30,32,30,36,36,36,36,36,36,36,36,36,36,36,36,36,36,36,36,30,32,32,32,30,30,32,32,32,32,32,30,36,36,36,36,36,36,36,36,36,36,36,36,36,36,36,36,30,32,30,32,32,32,30,32,32,32,32,30,30,32,32,32,30,30,32,32,32,30,36,36,36,36,36,36,36,36
0,0,0,0,0,0,0,0,0,31,31,31,31,31,31,31,31,31,31,31,31,31,31,31,31,31,31,31,31,0,0,0,0,0,0,0,0,0,36,36,36,36,36,36,36,36,36,30,32,32,32,32,32,32,32,32,32,32,32,32,32,32,32,32,32,32,30,36,36,36,36,36,36,36,36,36,36,36,36,36,36,36,36,30,32,30,30,30,30,32,32,32,30,32,32,32,30,32,30,32,30,32,30,32,30,36,36,36,36,36,36,36,36,36,36,36,36,36,36,36,36,30,32,32,30,32,30,32,30,32,30,32,30,32,30,32,30,36,36,36,36,36,36,36,36,36,36,36,36,36,36,36,36,30,30,30,32,32,30,30,30,32,32,30,30,36,36,36,36,36,36,36,36,36,36,36,36,36,36,36,36,30,32,30,32,30,30,30,32,30,32,32,30,32,32,32,32,32,30,30,30,32,30,36,36,36,36,36,36,36,36
0,0,0,0,0,0,0,0,0,31,31,31,31,31,31,31,31,31,31,31,31,31,31,31,31,31,31,31,31,0,0,0,0,0,0,0,0,0,36,36,36,36,36,36,36,36,36,30,30,30,30,30,30,30,30,30,30,30,30,30,30,30,30,32,32,32,30,36,36,36,36,36,36,36,36,36,36,36,36,36,36,36,36,30,32,32,32,32,30,30,30,30,30,32,30,32,30,32,30,32,30,32,30,32,30,36,36,36,36,36,36,36,36,36,36,36,36,36,36,36,36,30,32,32,30,32,32,32,32,32,30,32,30,32,30,32,30,36,36,36,36,36,36,36,36,36,36,36,36,36,36,36,36,36,36,30,30,32,32,30,32,32,30,30,36,36,36,36,36,36,36,36,36,36,36,36,36,36,36,36,36,30,32,32,32,30,32,32,32,30,30,30,30,32,32,32,32,32,30,32,30,32,30,36,36,36,36,36,36,36,36
0,0,0,0,0,0,0,0,0,31,31,31,31,31,31,31,31,31,31,31,31,31,31,31,31,31,31,31,31,0,0,0,0,0,0,0,0,0,36,36,36,36,36,36,36,36,36,36,36,36,36,36,36,36,36,36,36,36,36,36,36,36,30,30,32,30,30,36,36,36,36,36,36,36,36,36,36,36,36,36,36,36,36,30,32,30,32,32,30,32,32,32,32,32,32,32,32,32,32,32,32,32,32,32,30,36,36,36,36,36,36,36,36,36,36,36,36,36,36,36,36,30,32,32,30,32,30,32,30,32,30,30,30,30,30,32,30,36,36,36,36,36,36,36,36,36,36,36,36,36,36,36,36,36,36,36,30,30,32,32,32,30,30,36,36,36,36,36,36,36,36,36,36,36,36,36,36,36,36,36,36,30,32,30,30,30,32,30,32,30,32,30,30,32,32,32,32,32,30,32,30,32,30,36,36,36,36,36,36,36,36
0,0,0,0,0,0,0,0,0,31,31,31,31,31,31,31,31,31,31,31,31,31,31,31,31,31,31,31,31,0,0,0,0,0,0,0,0,0,36,36,36,36,36,36,36,36,36,36,36,36,36,36,36,36,36,36,36,36,36,36,36,36,36,36,36,36,36,36,36,36,36,36,36,36,36,36,36,36,36,36,36,36,36,30,32,30,32,30,30,32,30,30,30,32,30,30,30,30,30,32,30,30,30,32,30,36,36,36,36,36,36,36,36,36,36,36,36,36,36,36,36,30,32,32,30,32,32,32,32,32,30,32,32,32,32,32,30,36,36,36,36,36,36,36,36,36,36,36,36,36,36,36,36,36,36,36,36,30,30,32,30,30,36,36,36,36,36,36,36,36,36,36,36,36,36,36,36,36,36,36,36,30,32,30,32,30,32,30,32,30,32,30,32,32,32,32,32,30,30,32,32,32,30,36,36,36,36,36,36,36,36
0,0,0,0,0,0,0,0,0,31,31,31,31,31,31,31,31,31,31,31,31,31,31,31,31,31,32,31,31,0,0,0,0,0,0,0,0,0,36,36,36,36,36,36,36,36,36,36,36,36,36,36,36,36,36,36,36,36,36,36,36,36,36,36,36,36,36,36,36,36,36,36,36,36,36,36,36,36,36,36,36,36,36,30,32,30,32,30,32,32,32,32,32,32,30,32,32,32,32,32,30,32,32,32,30,36,36,36,36,36,36,36,36,36,36,36,36,36,36,36,36,30,32,30,30,30,30,30,30,30,30,30,30,30,30,32,30,36,36,36,36,36,36,36,36,36,36,36,36,36,36,36,36,36,36,36,36,36,30,30,30,36,36,36,36,36,36,36,36,36,36,36,36,36,36,36,36,36,36,36,36,30,32,30,32,30,32,32,32,30,32,30,32,32,30,30,30,30,30,32,30,32,30,36,36,36,36,36,36,36,36
0,0,0,0,0,0,0,0,0,19,30,32,32,30,32,30,1,1,1,1,1,1,1,1,31,31,32,31,31,0,0,0,0,0,0,0,0,0,36,36,36,36,36,36,36,36,36,36,36,36,36,36,36,36,36,36,36,36,36,36,36,36,36,36,36,36,36,36,36,36,36,36,36,36,36,36,36,36,36,36,36,36,36,30,32,30,32,30,32,30,32,30,30,32,30,30,30,30,30,32,32,32,32,32,30,36,36,36,36,36,36,36,36,36,36,36,36,36,36,36,36,30,32,32,30,32,32,32,32,32,32,32,32,30,32,32,30,36,36,36,36,36,36,36,36,36,36,36,36,36,36,36,36,36,36,36,36,36,36,36,36,36,36,36,36,36,36,36,36,36,36,36,36,36,36,36,36,36,36,36,36,30,32,30,32,30,32,30,30,30,32,30,30,30,30,32,30,32,32,32,30,32,30,36,36,36,36,36,36,36,36
0,0,0,0,0,0,0,0,0,19,30,32,32,33,32,30,1,1,0,32,32,32,0,1,1,1,32,1,1,0,0,0,0,0,0,0,0,0,36,36,36,36,36,36,36,36,36,36,36,36,36,36,36,36,36,36,36,36,36,36,36,36,36,36,36,36,36,36,36,36,36,36,36,36,36,36,36,36,36,36,36,36,36,30,32,30,32,32,32,30,32,32,32,32,30,32,32,32,30,32,30,30,32,32,30,36,36,36,36,36,36,36,36,36,36,36,36,36,36,36,36,30,32,32,32,32,32,32,32,32,32,32,32,32,32,32,30,36,36,36,36,36,36,36,36,36,36,36,36,36,36,36,36,36,36,36,36,36,36,36,36,36,36,36,36,36,36,36,36,36,36,36,36,36,36,36,36,36,36,36,36,30,32,30,32,30,32,30,32,32,32,32,32,32,32,32,30,32,32,30,30,32,30,36,36,36,36,36,36,36,36
0,0,0,0,0,0,0,0,0,30,30,32,30,30,30,30,1,0,0,32,1,32,32,32,32,32,32,32,32,0,0,0,0,0,0,0,0,0,36,36,36,36,36,36,36,36,36,36,36,36,36,36,36,36,36,36,36,36,36,36,36,36,36,36,36,36,36,36,36,36,36,36,36,36,36,36,36,36,36,36,36,36,36,30,32,30,32,32,32,30,32,32,32,32,30,32,30,32,32,32,30,30,32,30,30,36,36,36,36,36,36,36,36,36,36,36,36,36,36,36,36,30,30,30,30,30,30,30,30,30,30,30,30,30,30,30,30,36,36,36,36,36,36,36,36,36,36,36,36,36,36,36,36,36,36,36,36,36,36,36,36,36,36,36,36,36,36,36,36,36,36,36,36,36,36,36,36,36,36,36,36,30,32,30,32,30,32,30,30,30,30,30,30,30,30,30,30,30,32,30,32,32,30,36,36,36,36,36,36,36,36
0,0,0,0,0,0,0,0,0,0,0,32,0,0,0,0,0,32,32,32,32,32,0,0,32,0,0,0,0,0,0,0,0,0,0,0,0,0,36,36,36,36,36,36,36,36,36,36,36,36,36,36,36,36,36,36,36,36,36,36,36,36,36,36,36,36,36,36,36,36,36,36,36,36,36,36,36,36,36,36,36,36,36,30,32,30,32,30,30,30,30,30,30,32,30,30,30,30,30,32,32,30,32,32,30,36,36,36,36,36,36,36,36,36,36,36,36,36,36,36,36,36,36,36,36,36,36,36,36,36,36,36,36,36,36,36,36,36,36,36,36,36,36,36,36,36,36,36,36,36,36,36,36,36,36,36,36,36,36,36,36,36,36,36,36,36,36,36,36,36,36,36,36,36,36,36,36,36,36,36,36,30,32,30,32,30,32,30,32,32,32,32,30,32,32,32,32,32,32,30,32,32,30,36,36,36,36,36,36,36,36
0,0,0,0,0,0,0,0,0,32,32,32,32,32,32,32,32,32,0,32,0,0,0,17,32,30,30,30,1,0,0,0,0,0,0,0,0,0,36,36,36,36,36,36,36,36,36,36,36,36,36,36,36,36,36,36,36,36,36,36,36,36,36,36,36,36,36,36,36,36,36,36,36,36,36,36,36,36,36,36,36,36,36,30,32,30,32,32,32,30,32,32,32,32,32,32,32,32,30,30,30,30,30,32,30,36,36,36,36,36,36,36,36,36,36,36,36,36,36,36,36,36,36,36,36,36,36,36,36,36,36,36,36,36,36,36,36,36,36,36,36,36,36,36,36,36,36,36,36,36,36,36,36,36,36,36,36,36,36,36,36,36,36,36,36,36,36,36,36,36,36,36,36,36,36,36,36,36,36,36,36,30,32,30,32,32,32,30,32,32,30,32,30,32,30,30,30,32,30,30,30,32,30,36,36,36,36,36,36,36,36
0,0,0,0,0,0,0,0,0,1,1,1,0,32,0,1,0,0,0,32,16,0,0,30,32,33,32,30,30,0,0,0,0,0,0,0,0,0,36,36,36,36,36,36,36,36,36,36,36,36,36,36,36,36,36,36,36,36,36,36,36,36,36,36,36,36,36,36,36,36,36,36,36,36,36,36,36,36,36,36,36,36,36,30,30,30,30,30,32,30,30,30,30,30,30,32,30,32,30,32,30,32,30,32,30,36,36,36,36,36,36,36,36,36,36,36,36,36,36,36,36,36,36,36,36,36,36,36,36,36,36,36,36,36,36,36,36,36,36,36,36,36,36,36,36,36,36,36,36,36,36,36,36,36,36,36,36,36,36,36,36,36,36,36,36,36,36,36,36,36,36,36,36,36,36,36,36,36,36,36,36,30,32,30,30,32,32,30,32,32,30,32,30,32,32,32,32,32,30,32,32,32,30,36,36,36,36,36,36,36,36
0,0,0,0,0,0,0,0,0,30,30,30,30,32,30,1,4,30,30,32,30,30,0,30,32,30,30,30,30,0,0,0,0,0,0,0,0,0,36,36,36,36,36,36,36,36,36,36,36,36,36,36,36,36,36,36,36,36,36,36,36,36,36,36,36,36,36,36,36,36,36,36,36,36,36,36,36,36,36,36,36,36,36,30,32,32,32,30,30,30,32,32,32,32,32,32,32,32,30,32,32,32,32,32,30,36,36,36,36,36,36,36,36,36,36,36,36,36,36,36,36,36,36,36,36,36,36,36,36,36,36,36,36,36,36,36,36,36,36,36,36,36,36,36,36,36,36,36,36,36,36,36,36,36,36,36,36,36,36,36,36,36,36,36,36,36,36,36,36,36,36,36,36,36,36,36,36,36,36,36,36,30,32,30,32,32,30,30,30,30,30,32,30,30,30,30,30,32,30,32,30,32,30,36,36,36,36,36,36,36,36
0,0,0,0,0,0,0,0,0,19,30,32,32,32,30,30,4,30,32,33,32,30,0,30,32,30,32,32,30,0,0,0,0,0,0,0,0,0,36,36,36,36,36,36,36,36,36,36,36,36,36,36,36,36,36,36,36,36,36,36,36,36,36,36,36,36,36,36,36,36,36,36,36,36,36,36,36,36,36,36,36,36,36,30,32,32,30,32,30,32,32,30,32,30,30,30,30,30,30,30,30,32,30,30,30,36,36,36,36,36,36,36,36,36,36,36,36,36,36,36,36,36,36,36,36,36,36,36,36,36,36,36,36,36,36,36,36,36,36,36,36,36,36,36,36,36,36,36,36,36,36,36,36,36,36,36,36,36,36,36,36,36,36,36,36,36,36,36,36,36,36,36,36,36,36,36,36,36,36,36,36,30,32,30,32,32,32,32,32,32,32,32,30,32,32,32,32,32,30,32,30,32,30,36,36,36,36,36,36,36,36
0,0,0,0,0,0,0,0,0,19,30,30,30,30,30,19,30,30,32,32,32,30,0,30,32,32,32,32,30,0,0,0,0,0,0,0,0,0,36,36,36,36,36,36,36,36,36,36,36,36,36,36,36,36,36,36,36,36,36,36,36,36,36,36,36,36,36,36,36,36,36,36,36,36,36,36,36,36,36,36,36,36,36,30,32,32,32,32,30,30,30,30,30,30,32,30,32,32,32,30,32,32,32,32,30,36,36,36,36,36,36,36,36,36,36,36,36,36,36,36,36,36,36,36,36,36,36,36,36,36,36,36,36,36,36,36,36,36,36,36,36,36,36,36,36,36,36,36,36,36,36,36,36,36,36,36,36,36,36,36,36,36,36,36,36,36,36,36,36,36,36,36,36,36,36,36,36,36,36,36,36,30,32,30,30,30,30,30,30,30,30,30,30,30,30,30,30,32,30,30,30,32,30,36,36,36,36,36,36,36,36
0,0,0,0,0,0,0,0,0,19,19,19,19,19,19,19,19,30,30,30,30,30,0,30,30,30,30,30,30,0,0,0,0,0,0,0,0,0,36,36,36,36,36,36,36,36,36,36,36,36,36,36,36,36,36,36,36,36,36,36,36,36,36,36,36,36,36,36,36,36,36,36,36,36,36,36,36,36,36,36,36,36,36,30,32,32,32,32,32,32,32,32,32,32,32,32,32,30,32,32,32,30,32,32,30,36,36,36,36,36,36,36,36,36,36,36,36,36,36,36,36,36,36,36,36,36,36,36,36,36,36,36,36,36,36,36,36,36,36,36,36,36,36,36,36,36,36,36,36,36,36,36,36,36,36,36,36,36,36,36,36,36,36,36,36,36,36,36,36,36,36,36,36,36,36,36,36,36,36,36,36,30,32,32,32,32,32,32,32,32,32,32,32,32,32,32,32,32,32,32,32,32,30,36,36,36,36,36,36,36,36
0,0,0,0,0,0,0,0,0,0,0,0,0,0,0,0,0,0,0,0,0,0,0,0,0,0,0,0,0,0,0,0,0,0,0,0,0,0,36,36,36,36,36,36,36,36,36,36,36,36,36,36,36,36,36,36,36,36,36,36,36,36,36,36,36,36,36,36,36,36,36,36,36,36,36,36,36,36,36,36,36,36,36,30,30,30,30,30,30,30,30,30,30,30,30,30,30,30,30,30,30,30,30,30,30,36,36,36,36,36,36,36,36,36,36,36,36,36,36,36,36,36,36,36,36,36,36,36,36,36,36,36,36,36,36,36,36,36,36,36,36,36,36,36,36,36,36,36,36,36,36,36,36,36,36,36,36,36,36,36,36,36,36,36,36,36,36,36,36,36,36,36,36,36,36,36,36,36,36,36,36,30,30,30,30,30,30,30,30,30,30,30,30,30,30,30,30,30,30,30,30,30,30,36,36,36,36,36,36,36,36
0,0,0,0,0,0,0,0,0,0,0,0,0,0,0,0,0,0,0,0,0,0,0,0,0,0,0,0,0,0,0,0,0,0,0,0,0,0,36,36,36,36,36,36,36,36,36,36,36,36,36,36,36,36,36,36,36,36,36,36,36,36,36,36,36,36,36,36,36,36,36,36,36,36,36,36,36,36,36,36,36,36,36,36,36,36,36,36,36,36,36,36,36,36,36,36,36,36,36,36,36,36,36,36,36,36,36,36,36,36,36,36,36,36,36,36,36,36,36,36,36,36,36,36,36,36,36,36,36,36,36,36,36,36,36,36,36,36,36,36,36,36,36,36,36,36,36,36,36,36,36,36,36,36,36,36,36,36,36,36,36,36,36,36,36,36,36,36,36,36,36,36,36,36,36,36,36,36,36,36,36,36,36,36,36,36,36,36,36,36,36,36,36,36,36,36,36,36,36,36,36,36,36,36,36,36,36,36,36,36,36
0,0,0,0,0,0,0,0,0,0,0,0,0,0,0,0,0,0,0,0,0,0,0,0,0,0,0,0,0,0,0,0,0,0,0,0,0,0,36,36,36,36,36,36,36,36,36,36,36,36,36,36,36,36,36,36,36,36,36,36,36,36,36,36,36,36,36,36,36,36,36,36,36,36,36,36,36,36,36,36,36,36,36,36,36,36,36,36,36,36,36,36,36,36,36,36,36,36,36,36,36,36,36,36,36,36,36,36,36,36,36,36,36,36,36,36,36,36,36,36,36,36,36,36,36,36,36,36,36,36,36,36,36,36,36,36,36,36,36,36,36,36,36,36,36,36,36,36,36,36,36,36,36,36,36,36,36,36,36,36,36,36,36,36,36,36,36,36,36,36,36,36,36,36,36,36,36,36,36,36,36,36,36,36,36,36,36,36,36,36,36,36,36,36,36,36,36,36,36,36,36,36,36,36,36,36,36,36,36,36,36
0,0,0,0,0,0,0,0,0,0,0,0,0,0,0,0,0,0,0,0,0,0,0,0,0,0,0,0,0,0,0,0,0,0,0,0,0,0,36,36,36,36,36,36,36,36,36,36,36,36,36,36,36,36,36,36,36,36,36,36,36,36,36,36,36,36,36,36,36,36,36,36,36,36,36,36,36,36,36,36,36,36,36,36,36,36,36,36,36,36,36,36,36,36,36,36,36,36,36,36,36,36,36,36,36,36,36,36,36,36,36,36,36,36,36,36,36,36,36,36,36,36,36,36,36,36,36,36,36,36,36,36,36,36,36,36,36,36,36,36,36,36,36,36,36,36,36,36,36,36,36,36,36,36,36,36,36,36,36,36,36,36,36,36,36,36,36,36,36,36,36,36,36,36,36,36,36,36,36,36,36,36,36,36,36,36,36,36,36,36,36,36,36,36,36,36,36,36,36,36,36,36,36,36,36,36,36,36,36,36,36
0,0,0,0,0,0,0,0,0,0,0,0,0,0,0,0,0,0,0,0,0,0,0,0,0,0,0,0,0,0,0,0,0,0,0,0,0,0,36,36,36,36,36,36,36,36,36,36,36,36,36,36,36,36,36,36,36,36,36,36,36,36,36,36,36,36,36,36,36,36,36,36,36,36,36,36,36,36,36,36,36,36,36,36,36,36,36,36,36,36,36,36,36,36,36,36,36,36,36,36,36,36,36,36,36,36,36,36,36,36,36,36,36,36,36,36,36,36,36,36,36,36,36,36,36,36,36,36,36,36,36,36,36,36,36,36,36,36,36,36,36,36,36,36,36,36,36,36,36,36,36,36,36,36,36,36,36,36,36,36,36,36,36,36,36,36,36,36,36,36,36,36,36,36,36,36,36,36,36,36,36,36,36,36,36,36,36,36,36,36,36,36,36,36,36,36,36,36,36,36,36,36,36,36,36,36,36,36,36,36,36
0,0,0,0,0,0,0,0,0,0,0,0,0,0,0,0,0,0,0,0,0,0,0,0,0,0,0,0,0,0,0,0,0,0,0,0,0,0,36,36,36,36,36,36,36,36,36,36,36,36,36,36,36,36,36,36,36,36,36,36,36,36,36,36,36,36,36,36,36,36,36,36,36,36,36,36,36,36,36,36,36,36,36,36,36,36,36,36,36,36,36,36,36,36,36,36,36,36,36,36,36,36,36,36,36,36,36,36,36,36,36,36,36,36,36,36,36,36,36,36,36,36,36,36,36,36,36,36,36,36,36,36,36,36,36,36,36,36,36,36,36,36,36,36,36,36,36,36,36,36,36,36,36,36,36,36,36,36,36,36,36,36,36,36,36,36,36,36,36,36,36,36,36,36,36,36,36,36,36,36,36,36,36,36,36,36,36,36,36,36,36,36,36,36,36,36,36,36,36,36,36,36,36,36,36,36,36,36,36,36,36
0,0,0,0,0,0,0,0,0,0,0,0,0,0,0,0,0,0,0,0,0,0,0,0,0,0,0,0,0,0,0,0,0,0,0,0,0,0,36,36,36,36,36,36,36,36,36,36,36,36,36,36,36,36,36,36,36,36,36,36,36,36,36,36,36,36,36,36,36,36,36,36,36,36,36,36,36,36,36,36,36,36,36,36,36,36,36,36,36,36,36,36,36,36,36,36,36,36,36,36,36,36,36,36,36,36,36,36,36,36,36,36,36,36,36,36,36,36,36,36,36,36,36,36,36,36,36,36,36,36,36,36,36,36,36,36,36,36,36,36,36,36,36,36,36,36,36,36,36,36,36,36,36,36,36,36,36,36,36,36,36,36,36,36,36,36,36,36,36,36,36,36,36,36,36,36,36,36,36,36,36,36,36,36,36,36,36,36,36,36,36,36,36,36,36,36,36,36,36,36,36,36,36,36,36,36,36,36,36,36,36
0,0,0,0,0,0,0,0,0,0,0,0,0,0,0,0,0,0,0,0,0,0,0,0,0,0,0,0,0,0,0,0,0,0,0,0,0,0,36,36,36,36,36,36,36,36,36,36,36,36,36,36,36,36,36,36,36,36,36,36,36,36,36,36,36,36,36,36,36,36,36,36,36,36,36,36,36,36,36,36,36,36,36,36,36,36,36,36,36,36,36,36,36,36,36,36,36,36,36,36,36,36,36,36,36,36,36,36,36,36,36,36,36,36,36,36,36,36,36,36,36,36,36,36,36,36,36,36,36,36,36,36,36,36,36,36,36,36,36,36,36,36,36,36,36,36,36,36,36,36,36,36,36,36,36,36,36,36,36,36,36,36,36,36,36,36,36,36,36,36,36,36,36,36,36,36,36,36,36,36,36,36,36,36,36,36,36,36,36,36,36,36,36,36,36,36,36,36,36,36,36,36,36,36,36,36,36,36,36,36,36
0,0,0,0,0,0,0,0,0,0,0,0,0,0,0,0,0,0,0,0,0,0,0,0,0,0,0,0,0,0,0,0,0,0,0,0,0,0,36,36,36,36,36,36,36,36,36,36,36,36,36,36,36,36,36,36,36,36,36,36,36,36,36,36,36,36,36,36,36,36,36,36,36,36,36,36,36,36,36,36,36,36,36,36,36,36,36,36,36,36,36,36,36,36,36,36,36,36,36,36,36,36,36,36,36,36,36,36,36,36,36,36,36,36,36,36,36,36,36,36,36,36,36,36,36,36,36,36,36,36,36,36,36,36,36,36,36,36,36,36,36,36,36,36,36,36,36,36,36,36,36,36,36,36,36,36,36,36,36,36,36,36,36,36,36,36,36,36,36,36,36,36,36,36,36,36,36,36,36,36,36,36,36,36,36,36,36,36,36,36,36,36,36,36,36,36,36,36,36,36,36,36,36,36,36,36,36,36,36,36,36
0,29,36,36,36,36,36,36,36,36,36,36,36,36,36,36,36,36,36,36,36,36,36,36,36,36,36,36,36,36,36,36,36,36,36,36,36,36,36,36,36,36,36,36,36,36,36,36,36,36,36,36,36,36,36,36,36,36,36,36,36,36,36,36,36,36,36,36,36,36,36,36,36,36,36,36,36,36,36,36,36,36,36,36,36,36,36,36,36,36,36,36,36,36,36,36,36,36,36,36,36,36,36,36,36,36,36,36,36,36,36,36,36,36,36,36,36,36,36,36,36,36,36,36,36,36,36,36,36,36,36,36,36,36,36,36,36,36,36,36,36,36,36,36,36,36,36,36,36,36,36,36,36,36,36,36,36,36,36,36,36,36,36,36,36,36,36,36,36,36,36,36,36,36,36,36,36,36,36,36,36,36,36,36,36,36,36,36,36,36,36,36,36,36,36,36,36,36,36,36,36,36,36,36,36,36,36,36,36,36,36

# monsters zone
zone_rows 1
zone_cols 6
zone_tiles_per_row 36
zone_tiles_per_col 38
zone_offset_rows 0
zone_offset_cols 0
# note: zone_data needs to be in decimal
zone_data
-1,-1,14,07,15,15

# zone <-> enemies
zone_enemies_rows 20
zone_enemies_cols 5
# note: zone_enemies_data needs to be in hexadecimal
zone_enemies_data
00,00,01,00,01,00
01,01,00,01,02,01
02,00,03,02,03,01
03,01,01,02,03,04
04,03,04,05,05,06
05,03,04,05,06,0B
06,05,06,0B,0C,0E
07,0B,0C,0D,0E,0E
08,0D,0F,12,12,19
09,0F,15,12,15,19
0A,15,16,17,1A,1C
0B,17,1A,1B,1C,10
0C,1A,1B,1C,1D,1F
0D,1D,1E,1F,1F,20
0E,08,09,0A,0B,0C
0F,11,12,13,14,17
10,1D,1E,1F,20,21
11,20,21,22,22,23
12,20,23,24,24,25
13,03,04,06,07,07
