# reference: http://www.realmofdarkness.net/dq/wp-content/img/nes/dw/maps/hauksness-3.png

map_name Hauksness
map_tileset tileset
map_type dungeon
map_out_of_bounds_tile_id 36
map_is_dark true
map_repel_has_no_effect true
map_reset_repel_on_enter true
map_reset_light_on_enter true
# col1 row1 col2 row2 teleportMapId teleportCol teleportRow teleportPlayerDirection areaUseFadeEffect, areaMusicId, areaIsDark, areaRepelHasNoEffect, areaResetRepel, areaResetLight
map_area 10 10 29 29 world 29 93 down true world false false false true
map_rows 40
map_cols 40
map_data
4,4,4,4,4,4,4,4,4,4,4,4,4,4,4,4,4,4,4,4,4,4,4,4,4,4,4,4,4,4,4,4,4,4,4,4,4,4,4,4
4,4,4,4,4,4,4,4,4,4,4,4,4,4,4,4,4,4,4,4,4,4,4,4,4,4,4,4,4,4,4,4,4,4,4,4,4,4,4,4
4,4,4,4,4,4,4,4,4,4,4,4,4,4,4,4,4,4,4,4,4,4,4,4,4,4,4,4,4,4,4,4,4,4,4,4,4,4,4,4
4,4,4,4,4,4,4,4,4,4,4,4,4,4,4,4,4,4,4,4,4,4,4,4,4,4,4,4,4,4,4,4,4,4,4,4,4,4,4,4
4,4,4,4,4,4,4,4,4,4,4,4,4,4,4,4,4,4,4,4,4,4,4,4,4,4,4,4,4,4,4,4,4,4,4,4,4,4,4,4
4,4,4,4,4,4,4,4,4,4,4,4,4,4,4,4,4,4,4,4,4,4,4,4,4,4,4,4,4,4,4,4,4,4,4,4,4,4,4,4
4,4,4,4,4,4,4,4,4,4,4,4,4,4,4,4,4,4,4,4,4,4,4,4,4,4,4,4,4,4,4,4,4,4,4,4,4,4,4,4
4,4,4,4,4,4,4,4,4,4,4,4,4,4,4,4,4,4,4,4,4,4,4,4,4,4,4,4,4,4,4,4,4,4,4,4,4,4,4,4
4,4,4,4,4,4,4,4,4,4,4,4,4,4,4,4,4,4,4,4,4,4,4,4,4,4,4,4,4,4,4,4,4,4,4,4,4,4,4,4
4,4,4,4,4,4,4,4,4,4,4,4,4,4,4,4,4,4,4,4,4,4,4,4,4,4,4,4,4,4,4,4,4,4,4,4,4,4,4,4
4,4,4,4,4,4,4,4,4,4,30,30,4,4,0,30,30,4,30,30,30,30,30,30,30,32,32,30,35,30,4,4,4,4,4,4,4,4,4,4
4,4,4,4,4,4,4,4,4,4,30,4,4,0,1,30,4,32,32,33,32,30,1,0,0,4,32,35,35,30,4,4,4,4,4,4,4,4,4,4
4,4,4,4,4,4,4,4,4,4,4,4,4,1,0,30,30,32,32,30,32,30,0,0,0,32,35,35,4,30,4,4,4,4,4,4,4,4,4,4
4,4,4,4,4,4,4,4,4,4,4,0,0,0,35,35,30,30,32,30,30,30,0,35,0,32,32,35,4,4,4,4,4,4,4,4,4,4,4,4
4,4,4,4,4,4,4,4,4,4,4,4,0,0,0,35,35,0,32,0,0,0,1,0,0,32,32,0,4,30,4,4,4,4,4,4,4,4,4,4
4,4,4,4,4,4,4,4,4,4,30,0,32,32,32,4,35,4,32,32,32,4,4,32,32,4,32,0,0,30,4,4,4,4,4,4,4,4,4,4
4,4,4,4,4,4,4,4,4,4,30,0,32,32,32,32,4,32,32,4,4,4,32,32,32,32,32,0,1,0,4,4,4,4,4,4,4,4,4,4
4,4,4,4,4,4,4,4,4,4,0,0,32,32,0,4,4,4,0,1,0,0,0,0,0,0,32,0,0,1,4,4,4,4,4,4,4,4,4,4
4,4,4,4,4,4,4,4,4,4,30,0,32,32,0,4,30,30,30,30,4,30,32,32,32,30,32,30,30,0,4,4,4,4,4,4,4,4,4,4
4,4,4,4,4,4,4,4,4,4,32,32,4,32,0,30,32,32,32,4,4,30,35,0,30,32,33,35,30,4,4,4,4,4,4,4,4,4,4,4
4,4,4,4,4,4,4,4,4,4,32,4,32,32,0,30,30,30,33,30,30,30,0,35,30,32,35,35,30,35,4,4,4,4,4,4,4,4,4,4
4,4,4,4,4,4,4,4,4,4,1,1,32,32,1,30,4,4,32,32,32,30,1,0,30,30,35,30,30,35,4,4,4,4,4,4,4,4,4,4
4,4,4,4,4,4,4,4,4,4,1,0,4,32,1,30,4,30,32,30,4,30,1,1,4,4,35,35,1,30,4,4,4,4,4,4,4,4,4,4
4,4,4,4,4,4,4,4,4,4,30,0,32,4,1,30,32,32,32,4,4,4,1,4,0,30,30,30,30,4,4,4,4,4,4,4,4,4,4,4
4,4,4,4,4,4,4,4,4,4,30,0,32,32,0,30,30,32,32,30,30,30,4,0,0,30,4,4,4,30,4,4,4,4,4,4,4,4,4,4
4,4,4,4,4,4,4,4,4,4,30,35,4,32,0,4,4,1,32,4,32,32,32,32,4,32,32,33,4,30,4,4,4,4,4,4,4,4,4,4
4,4,4,4,4,4,4,4,4,4,35,35,32,32,0,0,4,0,32,1,0,0,0,0,0,30,32,30,4,4,4,4,4,4,4,4,4,4,4,4
4,4,4,4,4,4,4,4,4,4,4,35,32,4,32,32,32,32,4,0,0,0,35,0,0,30,30,30,30,30,4,4,4,4,4,4,4,4,4,4
4,4,4,4,4,4,4,4,4,4,30,35,35,35,0,0,0,0,0,0,0,35,35,35,0,4,4,4,4,4,4,4,4,4,4,4,4,4,4,4
4,4,4,4,4,4,4,4,4,4,4,4,35,30,30,30,30,0,30,35,35,35,35,30,30,30,4,30,30,30,4,4,4,4,4,4,4,4,4,4
4,4,4,4,4,4,4,4,4,4,4,4,4,4,4,4,4,4,4,4,4,4,4,4,4,4,4,4,4,4,4,4,4,4,4,4,4,4,4,4
4,4,4,4,4,4,4,4,4,4,4,4,4,4,4,4,4,4,4,4,4,4,4,4,4,4,4,4,4,4,4,4,4,4,4,4,4,4,4,4
4,4,4,4,4,4,4,4,4,4,4,4,4,4,4,4,4,4,4,4,4,4,4,4,4,4,4,4,4,4,4,4,4,4,4,4,4,4,4,4
4,4,4,4,4,4,4,4,4,4,4,4,4,4,4,4,4,4,4,4,4,4,4,4,4,4,4,4,4,4,4,4,4,4,4,4,4,4,4,4
4,4,4,4,4,4,4,4,4,4,4,4,4,4,4,4,4,4,4,4,4,4,4,4,4,4,4,4,4,4,4,4,4,4,4,4,4,4,4,4
4,4,4,4,4,4,4,4,4,4,4,4,4,4,4,4,4,4,4,4,4,4,4,4,4,4,4,4,4,4,4,4,4,4,4,4,4,4,4,4
4,4,4,4,4,4,4,4,4,4,4,4,4,4,4,4,4,4,4,4,4,4,4,4,4,4,4,4,4,4,4,4,4,4,4,4,4,4,4,4
4,4,4,4,4,4,4,4,4,4,4,4,4,4,4,4,4,4,4,4,4,4,4,4,4,4,4,4,4,4,4,4,4,4,4,4,4,4,4,4
4,4,4,4,4,4,4,4,4,4,4,4,4,4,4,4,4,4,4,4,4,4,4,4,4,4,4,4,4,4,4,4,4,4,4,4,4,4,4,4
4,4,4,4,4,4,4,4,4,4,4,4,4,4,4,4,4,4,4,4,4,4,4,4,4,4,4,4,4,4,4,4,4,4,4,4,4,4,4,4

# monsters zone
zone_rows 1
zone_cols 1
zone_tiles_per_row 40
zone_tiles_per_col 40
zone_offset_rows 0
zone_offset_cols 0
# note: zone_data needs to be in decimal
zone_data
13

# zone <-> enemies
zone_enemies_rows 20
zone_enemies_cols 5
# note: zone_enemies_data needs to be in hexadecimal
zone_enemies_data
00,00,01,00,01,00
01,01,00,01,02,01
02,00,03,02,03,01
03,01,01,02,03,04
04,03,04,05,05,06
05,03,04,05,06,0B
06,05,06,0B,0C,0E
07,0B,0C,0D,0E,0E
08,0D,0F,12,12,19
09,0F,15,12,15,19
0A,15,16,17,1A,1C
0B,17,1A,1B,1C,10
0C,1A,1B,1C,1D,1F
0D,1D,1E,1F,1F,20
0E,08,09,0A,0B,0C
0F,11,12,13,14,17
10,1D,1E,1F,20,21
11,20,21,22,22,23
12,20,23,24,24,25
13,03,04,06,07,07
