# reference: http://www.realmofdarkness.net/dq/wp-content/img/nes/dw/maps/kol-3.png

map_name Kol
map_tileset tileset
map_music town
map_out_of_bounds_tile_id 1
map_is_dark false
map_repel_has_no_effect true
map_reset_repel_on_enter true
map_reset_light_on_enter true
# col1 row1 col2 row2 teleportMapId teleportCol teleportRow teleportPlayerDirection areaUseFadeEffect, areaMusicId, areaIsDark, areaRepelHasNoEffect, areaResetRepel, areaResetLight
map_area 0 0 23 23 world 108 14 down true world false false false true
map_rows 24
map_cols 24
map_data
30,30,30,0,1,1,1,30,30,30,30,30,1,1,1,1,1,1,1,1,30,30,30,30
30,32,30,0,0,1,1,30,32,32,32,30,1,1,1,1,1,1,30,17,30,32,32,30
30,33,30,35,0,1,1,32,32,19,32,32,4,4,4,4,4,4,32,32,32,32,32,30
35,32,35,35,0,1,1,30,32,32,32,30,1,4,1,1,1,1,30,33,30,30,30,30
35,35,35,0,0,30,30,30,30,32,30,30,1,4,1,1,1,1,30,32,30,1,1,1
0,35,0,0,0,30,1,1,1,1,1,1,1,4,1,1,1,1,30,30,30,1,1,1
0,0,0,0,1,30,1,1,1,1,1,1,1,4,1,1,1,1,1,1,1,1,0,1
1,0,0,1,1,30,1,1,1,1,1,1,1,4,1,1,1,1,1,0,0,0,0,1
1,1,30,30,30,30,30,30,1,1,1,1,4,4,4,1,1,1,0,0,0,1,0,0
1,1,1,1,1,1,1,30,1,1,1,4,4,4,4,4,1,1,1,0,1,0,0,1
30,30,30,30,30,1,1,30,1,1,4,4,4,4,4,4,4,1,30,30,30,30,30,30
30,32,32,32,30,1,1,30,1,4,4,4,4,4,4,4,4,4,30,32,32,30,32,30
30,32,32,32,30,1,4,32,4,4,4,4,4,4,4,4,4,4,32,32,32,33,32,30
30,32,32,32,30,1,4,30,1,4,4,4,4,4,4,4,4,4,30,32,32,30,32,30
30,32,30,30,30,32,4,30,1,1,4,4,4,4,4,4,4,1,30,30,30,30,30,30
30,32,30,32,32,32,32,30,1,1,1,4,4,4,4,4,1,1,1,1,1,1,1,1
30,32,30,32,30,30,30,30,30,30,30,1,4,4,4,1,1,1,1,1,1,1,1,1
30,32,32,32,30,32,32,32,32,32,30,1,1,4,1,1,1,1,30,30,30,30,1,1
30,32,30,32,30,32,0,32,0,32,30,1,1,4,4,4,4,4,4,4,4,30,1,1
30,32,30,32,32,32,32,32,32,32,30,1,30,30,30,30,30,1,4,4,4,30,1,1
30,32,32,32,30,32,32,32,32,32,30,30,30,32,32,32,30,1,4,4,4,30,1,1
30,30,32,30,30,32,0,32,0,32,32,32,32,33,32,32,30,1,1,4,1,1,1,1
1,0,0,0,30,32,32,32,32,32,30,30,30,32,32,32,30,1,1,4,1,1,1,1
1,1,0,0,30,30,30,30,30,30,30,1,30,30,30,30,30,1,1,4,1,1,1,1
