# reference: http://www.realmofdarkness.net/dq/wp-content/img/nes/dw/maps/swamp-cave-2.png

map_name Swamp Cave
map_tileset tileset
map_music dungeon
map_out_of_bounds_tile_id 36
map_is_dark true
map_repel_has_no_effect true
map_reset_repel_on_enter true
map_reset_light_on_enter true
map_rows 54
map_cols 30
map_data
36,36,36,36,36,36,36,36,36,36,36,36,36,36,36,36,36,36,36,36,36,36,36,36,36,36,36,36,36,36
36,36,36,36,36,36,36,36,36,36,36,36,36,36,36,36,36,36,36,36,36,36,36,36,36,36,36,36,36,36
36,36,36,36,36,36,36,36,36,36,36,36,36,36,36,36,36,36,36,36,36,36,36,36,36,36,36,36,36,36
36,36,36,36,36,36,36,36,36,36,36,36,36,36,36,36,36,36,36,36,36,36,36,36,36,36,36,36,36,36
36,36,36,36,36,36,36,36,36,36,36,36,36,36,36,36,36,36,36,36,36,36,36,36,36,36,36,36,36,36
36,36,36,36,36,36,36,36,36,36,36,36,36,36,36,36,36,36,36,36,36,36,36,36,36,36,36,36,36,36
36,36,36,36,36,36,36,36,36,36,36,36,36,36,36,36,36,36,36,36,36,36,36,36,36,36,36,36,36,36
36,36,36,36,36,36,36,36,36,36,36,36,36,36,36,36,36,36,36,36,36,36,36,36,36,36,36,36,36,36
36,36,36,36,36,36,36,36,36,36,36,36,36,36,36,36,36,36,36,36,36,36,36,36,36,36,36,36,36,36
36,36,36,36,36,36,36,36,36,36,36,36,36,36,36,36,36,36,36,36,36,36,36,36,36,36,36,36,36,36
36,36,36,36,36,36,36,36,36,36,30,30,30,30,30,30,30,30,30,30,36,36,36,36,36,36,36,36,36,36
36,36,36,36,36,36,36,36,36,36,30,30,30,30,30,30,30,30,30,30,36,36,36,36,36,36,36,36,36,36
36,36,36,36,36,36,36,36,36,36,30,32,32,32,32,32,32,32,30,30,36,36,36,36,36,36,36,36,36,36
36,36,36,36,36,36,36,36,36,36,30,30,32,30,30,32,30,30,30,30,36,36,36,36,36,36,36,36,36,36
36,36,36,36,36,36,36,36,36,36,30,30,32,30,32,32,30,32,30,30,36,36,36,36,36,36,36,36,36,36
36,36,36,36,36,36,36,36,36,36,30,30,32,30,30,32,32,32,30,30,36,36,36,36,36,36,36,36,36,36
36,36,36,36,36,36,36,36,36,36,30,30,32,32,32,32,30,32,30,30,36,36,36,36,36,36,36,36,36,36
36,36,36,36,36,36,36,36,36,36,30,30,32,30,32,30,30,32,30,30,36,36,36,36,36,36,36,36,36,36
36,36,36,36,36,36,36,36,36,36,30,30,32,32,30,30,32,32,30,30,36,36,36,36,36,36,36,36,36,36
36,36,36,36,36,36,36,36,36,36,30,30,32,30,30,32,32,32,30,30,36,36,36,36,36,36,36,36,36,36
36,36,36,36,36,36,36,36,36,36,30,30,32,32,32,32,30,32,30,30,36,36,36,36,36,36,36,36,36,36
36,36,36,36,36,36,36,36,36,36,30,30,32,30,32,30,30,32,30,30,36,36,36,36,36,36,36,36,36,36
36,36,36,36,36,36,36,36,36,36,30,30,32,30,32,32,32,32,30,30,36,36,36,36,36,36,36,36,36,36
36,36,36,36,36,36,36,36,36,36,30,30,32,30,32,32,30,32,30,30,36,36,36,36,36,36,36,36,36,36
36,36,36,36,36,36,36,36,36,36,30,30,32,30,32,30,30,32,30,30,36,36,36,36,36,36,36,36,36,36
36,36,36,36,36,36,36,36,36,36,30,30,32,30,32,32,40,32,30,30,36,36,36,36,36,36,36,36,36,36
36,36,36,36,36,36,36,36,36,36,30,30,32,30,30,30,40,30,30,30,36,36,36,36,36,36,36,36,36,36
36,36,36,36,36,36,36,36,36,36,30,30,32,30,32,32,40,32,30,30,36,36,36,36,36,36,36,36,36,36
36,36,36,36,36,36,36,36,36,36,30,30,32,30,32,30,30,30,30,30,36,36,36,36,36,36,36,36,36,36
36,36,36,36,36,36,36,36,36,36,30,30,32,30,32,30,32,32,30,30,36,36,36,36,36,36,36,36,36,36
36,36,36,36,36,36,36,36,36,36,30,30,32,30,32,30,32,32,30,30,36,36,36,36,36,36,36,36,36,36
36,36,36,36,36,36,36,36,36,36,30,30,32,30,32,30,32,32,30,30,36,36,36,36,36,36,36,36,36,36
36,36,36,36,36,36,36,36,36,36,30,30,32,30,32,30,30,32,30,30,36,36,36,36,36,36,36,36,36,36
36,36,36,36,36,36,36,36,36,36,30,30,32,30,32,32,32,32,30,30,36,36,36,36,36,36,36,36,36,36
36,36,36,36,36,36,36,36,36,36,30,30,32,30,30,30,30,30,30,30,36,36,36,36,36,36,36,36,36,36
36,36,36,36,36,36,36,36,36,36,30,30,32,32,32,32,30,32,30,30,36,36,36,36,36,36,36,36,36,36
36,36,36,36,36,36,36,36,36,36,30,30,32,30,30,32,30,32,30,30,36,36,36,36,36,36,36,36,36,36
36,36,36,36,36,36,36,36,36,36,30,30,32,32,30,32,32,32,30,30,36,36,36,36,36,36,36,36,36,36
36,36,36,36,36,36,36,36,36,36,30,30,30,32,32,32,30,30,30,30,36,36,36,36,36,36,36,36,36,36
36,36,36,36,36,36,36,36,36,36,30,30,30,30,30,32,32,32,30,30,36,36,36,36,36,36,36,36,36,36
36,36,36,36,36,36,36,36,36,36,30,30,32,32,30,32,30,32,30,30,36,36,36,36,36,36,36,36,36,36
36,36,36,36,36,36,36,36,36,36,30,30,32,32,32,32,30,32,30,30,36,36,36,36,36,36,36,36,36,36
36,36,36,36,36,36,36,36,36,36,30,30,30,30,30,30,30,30,30,30,36,36,36,36,36,36,36,36,36,36
36,36,36,36,36,36,36,36,36,36,30,30,30,30,30,30,30,30,30,30,36,36,36,36,36,36,36,36,36,36
36,36,36,36,36,36,36,36,36,36,36,36,36,36,36,36,36,36,36,36,36,36,36,36,36,36,36,36,36,36
36,36,36,36,36,36,36,36,36,36,36,36,36,36,36,36,36,36,36,36,36,36,36,36,36,36,36,36,36,36
36,36,36,36,36,36,36,36,36,36,36,36,36,36,36,36,36,36,36,36,36,36,36,36,36,36,36,36,36,36
36,36,36,36,36,36,36,36,36,36,36,36,36,36,36,36,36,36,36,36,36,36,36,36,36,36,36,36,36,36
36,36,36,36,36,36,36,36,36,36,36,36,36,36,36,36,36,36,36,36,36,36,36,36,36,36,36,36,36,36
36,36,36,36,36,36,36,36,36,36,36,36,36,36,36,36,36,36,36,36,36,36,36,36,36,36,36,36,36,36
36,36,36,36,36,36,36,36,36,36,36,36,36,36,36,36,36,36,36,36,36,36,36,36,36,36,36,36,36,36
36,36,36,36,36,36,36,36,36,36,36,36,36,36,36,36,36,36,36,36,36,36,36,36,36,36,36,36,36,36
36,36,36,36,36,36,36,36,36,36,36,36,36,36,36,36,36,36,36,36,36,36,36,36,36,36,36,36,36,36
36,36,36,36,36,36,36,36,36,36,36,36,36,36,36,36,36,36,36,36,36,36,36,36,36,36,36,36,36,36

# monsters zone
zone_rows 1
zone_cols 1
zone_tiles_per_row 54
zone_tiles_per_col 30
zone_offset_rows 0
zone_offset_cols 0
# note: zone_data needs to be in decimal
zone_data
19

# zone <-> enemies
zone_enemies_rows 20
zone_enemies_cols 5
# note: zone_enemies_data needs to be in hexadecimal
zone_enemies_data
00,00,01,00,01,00
01,01,00,01,02,01
02,00,03,02,03,01
03,01,01,02,03,04
04,03,04,05,05,06
05,03,04,05,06,0B
06,05,06,0B,0C,0E
07,0B,0C,0D,0E,0E
08,0D,0F,12,12,19
09,0F,15,12,15,19
0A,15,16,17,1A,1C
0B,17,1A,1B,1C,10
0C,1A,1B,1C,1D,1F
0D,1D,1E,1F,1F,20
0E,08,09,0A,0B,0C
0F,11,12,13,14,17
10,1D,1E,1F,20,21
11,20,21,22,22,23
12,20,23,24,24,25
13,03,04,06,07,07
